GGGGGGGGGGGGGGGGGGGGGGGGGGMMMMMMMMMMMMMMMMMMMMMMMMMMMMMM
GGGGGGGGGGGGGGGGGGGGGGGGGGMMMMMMMMMMMMMMMMMMMMMMMMMMMMMM
GGGGGGGGGGGGGGGGGGGGGGGGGGMMMMMMMMMMMMMMMMMMMMMMMMMMMMMM
GGGGGGGGGGGGGGGGGGGGGGGGMMMMMMMMMMMMMMMMMMMMMMMMMMMMMMMM
GGGGGGGGGGGGGGGGGGGGGMMMMMMMMMMMMMMMMMMMMMMMMMMMMMMMMMMM
GGGGGGGGGGGGGGGGGGGGMMMMMMMMMMMMMMMMMMMMMMMMMMMMMMMMMMMM
GGGGGGGGGGGGGGGGGGGMMMMMMMMMMMMMMMMMMMMMMMMMMMMMMMMMMMMM
GGGGGGGGGGGGGGGGGGMMMFFFFFFFFMMMMMMMMMMMMMMMMMMMMMMMMMMM
GGGGGGGGGGGGGGGGMMMMFFFFFFFFFFFFMMMMMMMMMMMMMMMMMMMMMMMM
GGGGGGGGGGGGGGGMMMMFFFFFFFFFFFFFFMMMMMMMMMMMMMMMMMMMMMMM
GGGGGGGGGGGGGGGMMMFFFFFFFFFFFFFFFFFMMMMMMMMMMMMMMMMMMMMM
GGGGGGGGGGGGGGMMMFFFFFFFFFFFFFFFFFFFMMMMMMMMMMMMMMMMMMMM
GGGGGGGGGGGGGMMMMFFFFFFFFFFFFFFFFFFFFMMMMMMMMMMMMMMMMMMM
GGGGGGGGGGGGGMMMFFFFFFFFFFFFFFFFFFFFFFMMMMMMMMMMMMMMMMMM
GGGGGGGGGGGGMMMMFFFFFFFFFFFFFFFFFFFFFFFMMMMMMMMMMMMMMMGG
GGGGGGGGGGGGMMMFFFFFFFFFFFFFFFFFFFFFFFFFMMMMMMMMMMMMMGGG
GGGGGGGGGGGMMMMFFFFFFFFFFFFFFFFFFFFFFFFFFMMMMMMMMMMMGGGG
GGGGGGGGGGGMMMFFFFFFFFFFFFFFFFFFFFFFFFFFFFMMMMMMMMMGGGGG
GGGGGGGGGGMMMMFFFFFFFFFFFFFFFFFFFFFFFFFFFFFMMMMMMMGGGGGG
GGGGGGGGGGMMMFFFFFFFFFFFFFFFFFFFFFFFFFFFFFFFMMMMGGGGGGGG
GGGGGGGGGMMMMFFFFFFFFFFFFFFFFFFFFFFFFFFFFFFFMMMGGGGGGGGG
GGGGGGGGGMMMFFFFFFFFFFFFFFFFFFFFFFFFFFFFFFFFMMMGGGGGGGGG
GGGGGGGGMMMMFFFFFFFFFFFFFFFFFFFFFFFFFFFFFFFFMMMGGGGGGGGG
GGGGGGGGMMMMFFFFFFFFFFFFFFFFFFFFFFFFFFFFFFFFMMMGGGGGGGGG
GGGGGGGGMMMFFFFFFFFFFFFFFFFFFFFFFFFFFFFFFFFFMMMGGGGGGGGG
GGGGGGGGMMMFFFFFFFFFFFFFFFFFFFFFFFFFFFFFFFFFMMMGGGGGGGGG
GGGGGGGGMMMFFFFFFFFFFFFFFFFFFFFFFFFFFFFFFFFFMMMGGGGGGGGG
GGGGGGGGMMMFFFFFFFFFFFFFFFFFFFFFFFFFFFFFFFFFMMMGGGGGGGGG
GGGGGGGMMMMFFFFFFFFFFFFFFFFFFFFFFFFFFFFFFFFFMMMGGGGGGGGG
GGGGGGGMMMMFFFFFFFFFFFFFFFFFFFFFFFFFFFFFFFFFMMMGGGGGGGGF
GGGGGGGMMMMFFFFFFFFFFFFFFFFFFFFFFFFFFFFFFFFFMMMGGGGGGGFF
GGGGGGGMMMMFFFFFFFFFFFFFFFFFFFFFFFFFFFFFFFFFMMMGGGGGGGFF
GGGGGGMMMMMFFFFFFFFFFFFFFFFFFFFFFFFFFFFFFFFMMMMGGGGGGFFF
GGGGGGMMMMMMFFFFFFFFFFFFFFFFFFFFFFFFFFFFFFMMMMGGGGGGFFFF
FFFFFFMMMMMMFFFFFFFFFFFFFFFFFFFFFFFFFFFFFFMMMGGGGGGFFFFF
FFFFFFFMMMMMMFFFFFFFFFFFFFFFFFFFFFFFFFFFFMMMMGGGGGGFFFFF
FFFFFFFFMMMMMMFFFFFFFFFFFFFFFFFFFFFFFFFFFMMMGGGGGGGFFFFF
FFFFFFFFMMMMMMMMFFFFFFFFFFFFFFFFFFFFFFFFMMMMGGGGGGFFFFFF
FFFFFFFFFMMMMMMMFFFFFFFFFFFFFFFFFFFFFFFMMMMGGGGGGGFFFFFF
FFFFFFFFFFMMMMMMMMFFFFFFFFFFFFFFFFFFFFMMMMGGGGGGGGFFFFFF
FFFFFFFFFFMMMMMMMMMFFFFFFFFFFFFFFFFFFFMMMMGGGGGGGGFFFFFF
FFFFFFFFFFFMMMMMMMMFFFFFFFFFFFFFFFFFFMMMMGGGGGGGGGFFFFFF
FFFFFFFFFFFFMMMMMMMMFFFFFFFFFFFFFFFFMMMMMGGGGGGGGGFFFFFF
FFFFFFFFFFFFMMMMMMMMMFFFFFFFFFFFFFFMMMMMGGGGGGGGGGFFFFFF
FFFFFFFFFFFFFMMMMMMMMMMMMMMMMMMMMMMMMMMMGGGGGGGGGGFFFFFF
FFFFFFFFFFFFFFMMMMMMMMMMMMMMMMMMMMMMMMMMGGGGGGGGGGGFFFFF
FFFFFFFFFFFFFFFMMMMMMMMMMMMMMMMMMMMMMMMMGGGGGGGGGGGGFFFF
FFFFFFFFFFFFFFFFMMMMMMMMMMMMMMMMMMMMMMMMFGGGGGGGGGGGGFFF
FFFFFFFFFFFFFFFFFFMMMMMMMMMMMMMMMMMMMFFFFGGGGGGGGGGGGGFF
MMMMFFFFFFFFFFFFFFFFFFFFMMMMMMMMMMFFFFFFFFGGGGGGGGGGGGGF
MMMMMMFFFFFFFFFFFFFFFFFFFFMMMMMMFFFFFFFFFFFGGGGGGGGGGGGG
MMMMMMMFFFFFFFFFFFFFFFFFFFFFFFFFFFFFFFFFFFFFGGGGGGGGGGGG
MMMMMMMMFFFFFFFFFFFFFFFFFFFFFFFFFFFFFFFFFFFFGGGGGGGGGGGG
MMMMMMMMMMFFFFFFFFFFFFFFFFFFFFFFFFFFFFFFFFFFFGGGGGGGGGGG
MMMMMMMMMMMFFFFFFFFFFFFFFFFFFFFFFFFFFFFFFFFFFGGGGGGGGGGG
MMMMMMMMMMMMFFFFFFFFFFFFFFFFFFFFFFFFFFFFFFFFFFGGGGGGGGGG
